2222222222
2430040342
2000000002
2003304342
2001340002
2000340002
2003304002
2000000342
2400000342
2222222222