2222222222
2000040002
2000000002
2003304002
2001340002
2000340002
2003304002
2000000002
2400000002
2222222222